11111
100P1
1EC01

100C1
11111